NO assets/floor.xpm
SO assets/eagle.xpm
WE assets/wall_2.xpm
EA assets/back.xpm

F 9, 169, 182
C 234, 213, 218

1111111111111111111111111111111111111111
1000001000001000000100000010001000010001
1000001000001000000000000010000000000001
1000001000001000000100000010001000010001
1000000000000001011111011110001000010001
1000001000001000000100000011111111110111
1000001000001000000100000010000000100001
1111111110111000000100000010000000100001
1000010000001111111111101110000000100001
1000000000001000000010000011011111110111
1000010000001000000010000010000000000001
1000010000001000000010000010000000100001
1000010000001111101110000000000000000001
1111111101111000000010000010000000000001
1000000000001000000000010111111111011111
1000000000001000000010000010001000010001
1000000000001000000010000010001000010001
1000000010001000000010000010000000000001
1000000010001000000010000010001000000001
1111111111111111111111111111111111101111
1000000010000001000000100010000010000001
1000000010000001000000100010000010000001
1000000010000001000000000010000010000001
1000000000000001000000100010000010000001
1000000011011111111011111111011111101111
111110111000000000000100001000S010000001
1000000010000001000001000010200000000001
1000000010000001000000000010005010000001
1000000010000001000000000011111111011111
1000000010000001111110111110000001000001
1000000010000001000000100010000000000001
1111111111011111000000000000000001000001
1000010001000001000000100010000001000001
1000010001000001000000100010000001000001
1000010000000001000000100011111111110111
1101111011110111111111101110000001000001
1000010001000001000001000010000000000001
1000000001000001000000000010000001000001
1000010001000001000001000010000001000001
1111111111111111111111111111111111111111
