NO assets/floor.xpm
SO assets/eagle.xpm
WE assets/wall_2.xpm
EA assets/back.xpm

F 39, 235, 49
C 33, 242, 100

          11           111
          1111111      101
          1011         101
          10011        101
11111111111000111111111101
10000110000000000000000001
11111111111111111111111111
                           
11111111111111111111111111   11111111
         11100001           111000011
          1000011111     11110000001
          10000000011111 10000000001
          11001001000001110000011101
          10111111000000000100000101
          100000000N0000000000111101
          10110110000000111100011111
          110001111111111  11011
           11011           11111
            111
