NO .t3.xpm
SO .t4.xpm
WE .t1.xpm
EA .t2.xpm

F 112, 173, 168
C 43, 153, 181

111111111111111111111111111111111111111111111111111111111111111111111111111111111111111111111111111111111111111111111111111111111111111111111111111111
100000010000100010000000100010000100000010000001000010000100010000001000010000010000001000100001000000100000001000001000100001000001000010001000100001
100000010000100010000000100010000100000000000000000000000000000000000000010000010000001000000001000000100000001000001000000001000000000010000000100001
100000000000100010000000100000000100000010000001000010000100010000001000010000000000000000100001000000100000001000001000100001000001000010001000100001
100000010000110111111101100010000111101111111111111111111111111111111111111101110000001101110111110111100000001000001000000001000001000000001000000001
100000010000100010000000100010000100000010000010000100001000100000010000010000010000001000100001000000100000001000001000000001000001000010001000100001
100000010000100000000000111110111100000010000010000100000000000000000000010000011111011000100001000000110111111000001111011111111111111111101111111111
111110111100000010000000100010000100000010000010000100001000100000010000010000010000001000100001000000100000001111000000000001000001000010001000010001
100000000000111111111101100000000100000011110111011111111111111111011111111011110000001111110111111101100000001000001000000001000001000000001000010001
100000000000100000001000100010000100000010000010000100000100010000000100010000010000001000010001000000100000001000001000000001000001000010001000000001
100001000000100000001000100010000111101110000010000100000100010000000100010000010000001000010001000000100000001000001000100000000111111011111000010001
100001000000100000001000111110100000000010000000000100000100010000000100010000010000001000000001000000000000001111111110111111000001000010001000010001
100001000000100000000000100000000100000010000010000100000100000000000000000000010000001000010001101111100000001000000010000001000001000010001000010001
100001000000100000001000100000000100000011101111111100000100011111101100011111111101111111111111000000110111111000000010000001000000000000001110111111
111111111111111111101111100001000100000000000001000100000110110000000110110000001000100000100001000000100000000000000010000001000001000010001000100001
100010001000000100000000111111011100000010000000000111011100010000000100010000001000100000100001000000000000001000000000000001000001000010000000000001
100010001000000100000000100001000100000010000001000100000100010000000100010000000000000000100001000000000000001000000010000001000001000010001000100001
100010000000000100010000100001000111101111111111111100000100010000000100010000001000100000100001111111011111111111111111111111111111111111011000100001
100010001000000000010000100001000100000001000010000100000111111111110111110000001000100000100001000100000100001000100000100001000100010000001111111011
100010001000000000010000100000000100000001000000000111100000000001000000011101111000100000110111000100000100001000100000100001000100010000001000100001
110000011111111011111111100000000100000001000010000100000100000001000000010000001110111111100001000100000100000000100000000001000100010000001000100001
100010000010000000100000111110111100000001000010000100000100000001000000010000001000100000100001101110111111011101100000100001000100010000001000100001
100010000010000000100000100000000111101111111111011100000100000001000000010000001000100000100000000000000000001000111111111011000000000000001000000001
100010000010000000100000100000000100000000000010000110111100000001000000010000001000000000000001000100000100001000100001000001000100010000001000100001
110110000000000000100000100001000100000001000010000100000100000001110111111110111000100000100001000100000100001000100000000001111111111111111011111111
100010000010000000111101111111101100000001000000000100000111111011000000010000001101111111111111111111111110111101100001000001000000100001000000000001
100010000010000000100000100010000100000001000010000100000100000001000000010000001000001000010001000000100010001000100001000001000000000001000000000001
100011111111011111100000100000000100000001000000000100000100000000000000010000001000000000010001000000100010001000000001000001000000100001000000000001
100010001000010000100000100010000100000001000000000100000100000001000000011111011000001000010001000000100010001000100001000001000000100000000100000001
110110000000010000100000111111011111111111111101111111111111111111111101110000001000001000000001000000000110001111111111111011101111100001000100000001
100010001000010000111011100001000100001000010000000100001000010001000000010000001000001000010001110111100011011000001000010001000000111011000100000001
100011011000011101100000100001000100000000010000000100001000010001000000010000001000001000010001000000100010001000000000010001000000100001111111011111
100010001100000000100000100000000100001000010000000000001000010001000000011111101111111111111111000000100000001000001000000001000000100001000000000001
100010001000010000100000100001000111111101111011111100001110000011000000010000000100001000010001000000100010001000001000010001000000100001000000000001
100010001000010000000000110111111100000100010000000111011000010000000000010000000100001000010001111011111111111111111111111111000000100001000000100001
100010001000010000100000100001000100000100010000000100001000010001000000010000000100001000010001000001000010001000100001000001111111101111000000110111
111111111111111111101100000001000100000100000000000100000000010001111011111111101100001000011011000001000010001000100000000001000010000001111011100001
100010000010001000001000100001000110111110111111101100001111111011000000010000000000000000000001000001000000001000000001000001000000000001000000100001
100000000000000000001000100000000100000000010000000100001000010001000000010000000100001000010001000000000010000000100001000001000010000001000000100001
100010000010001000000000100001000100000100010000000100001000000001000000010000000100001000010001000001000010001000100001000001000010000001000000000001
100010000010001000001000100001000100000100010000000100001000010001000000010000000100001000010001000001000010001000100001000001000010000001000000100001
111111111111111111111111111101111111111111111111111111111111111111111111111111111111111111111111111111111111111111111111111111111111111111111111111111
100010001000010000000100000100010001000001000000100000010000001000100001000010001000001000000100010000010001000010001000000100001000001000010000100001
100010001000010000000100000100010001000001000000100000010000001000100000000000001000001000000100010000010001000010001000000000001000000000010000000001
100010000000010000000000000000010001000000000000100000010000001000100001000010001000000000000100010000010000000010001000000100001000001000010000100001
100000001000011111011100000100010001101111111011111100000000001000110111000010000000001111101100010000010001000010001000000100001110111111110000100001
100010001000010000000111110111110001000001000000100000011101111100000001101110001000001000000100011010000011011110001101111100001000010000011110111111
100010001000010000000100010000010001000001000000100000010000000000100001000011011111111000000110110000010001000010001000000110111000010000010000010001
111110111111110000000100010000011011000001000000100000010000000000100001000010001000001000000100000000010000000011011000000100001000000000010000000001
100000001000011110111100010000010001000001000000111110110000000000100001000010001000001000000100010000010001000010001000000100001000010000010000010001
100000001000010000000110111011110001111111101111100000011111110111111111111110001000001110111100011111111111110110001000000100001000010000011111111011
100000000000010000000100010000010001000010000000100000010000010000010000100010001000001000000110110001000100000010001111011111111000010000010001000001
100000001000000000000100000000010001000010000000100000010000000000000000100010000000001000000100010001000100000010000000000100001110111111110001000001
100000001000010000000100010000010001000010000000111101110000010000000000100010001000001000000100010001000000000010001000000000001000010000010000000001
111111111111111111111111011110000011000010000000100000010000011111101111110111111111111110111100010000000100000010001000000100001000010000010000000001
100000010000000100010000001000010001101110000000100000010000010001000000100010000100001000000100010001000100000011111101111111111000000000010000000001
100000010000000000010000001000010001000010000000100000010000010001000000100010000000001000000111011111111111111110001000001000001000000000011110111111
100000000000000100000000001000010001000011111101100000011011110001000000000010000100000000000100001000001000100010001000001000001111101111110000100001
100000010000000100010000000000010001000010000000111110110000011000000000100010000100001000000100000000000000000010001000000000001000000000010000100001
100000010000000100010000001110110001000000000000100000010000010001111011110111111101111111111100001000001000100010001111011000001000000000010000000001
111101111111111111111101111000011011000010000000100000010000010001000000100010000100010000000111111111111111101111011000001101111000000000010000000001
100000010001000001000100001000010001111111011111100000000000010001000000100010000100010000000100000100000010000010000000001000001000010000011111011111
100000010000000001000100001000010001000100001000100000000000010001000000100010000000010000000100000000000010000010001000001000001110111111110001000001
100000010001000001000100001000010000000100001000111111101111111111111111111110000100011111011100000100000010000010001000001000001000001000010001000001
110111111011111000001100001000010001000100001000100000000000001000000100000011011111110000000110111100000000000011111111111101111000001000010000000001
100000010000010001000110111000010001000100000000100000000000001000000100000010000100000000000100000111011111011110000010000000001000000000010001000001
100000010000010001000100001110110001000100001000100000010000001000000100000010000000010000000100000100000010000010000000000000001000001000010001000001
100000010000010001000100001000011011101111111101100000011110111000000000000010000100010000000000000100000000000010000010000010001000001000011101111111
100000010000000001101100001000010001000000001000111101110000000001011111101110000100010000000100000100000000000011101111111110001101111111110000100001
111011111110111011000000111000010001000100001000100000010000001000000100000011011111111111111111101111111101111110001000000011011000100000010000000001
100000010000010001000100001000010001000100000000000000010000001000000100000010000010000010000100000100000001000010001000000010001000100000010000100001
100000010000010001000100001000010001000100001000100000010000001000000100000010000010000000000100000100000001000010001000000010001000100000011011111111
100000010000010001000100001000010001101111111111110111111111111111101110111110000010000010000100000100000001000010000000000000001000000000010001000001
111111111111111011111111111111111111000010000000100000010000100001000100000011110111011110000100000111110111101111011101111110001000100000010000000001
100001000100001000000100000001000001000010000000100000010000100000000100000010000010000011011111011100000000000010001000000010001111101111110001000001
100001000100001000000000000001000001000010000000100000010000000001000100000010000010000010000100000100000001000010001000000011011000000000011011000001
100000000100001000000100000001000001000000000000100000000000100001000100000010000000000010000100000100000001000010001000000010001000000000010001110111
100000000110111000000100000001000001000010000000100000010000100001000100000010000010000010000100000100000001000010001000000010001000010000010001000001
111110111100001000000100000000000001111111111111111111111111111111111111111111110111111111111111111111111111111110001000000010001000010000010001000001
100000000100001000000100000001000001000100000001000100001000001000000100000100000000000100001000001000010001000011111111111111011111110111110001000001
100000000100001111011111111111111111000100000001000100001000001000000000000100000000000100001000001000000001000010001000000100001000000000011111101111
100001000100001000000010000000100001000100000001000100001000001000000100000100001000000000001000001000010000000010001000000100001000000000010001000001
111011101111011000000010000000100001000111110111101111011101111111111101111100001000000100001000001000010001000010000000000000001000001000010001000001
100001000100001000000010000000100001101100000000000100001000001000100001000100001111111111011000001111111101111110001000000100001000001000010000000001
100000000100001110111110000000100001000100000001000100000000001000100000000100000000100000000000000000010000100011111011111111111000001000010001000001
100001000100001000000011110111110111000000000001000000001000001000100000000110111000100000001101111000010000100010000010000010001000001000011111101111
110111111100001000000010000000100001000111111011111111111101111101100000000100001000100000001000001000000000100010000010000000001111111011110000000001
100010000110111000000000000000000001000100000001000100000100001000000110111100001100000101111000001000010000000010000010000010001000100000010000000001
10001000010000111111011000000000000100010000000000010000000000100010000000010000100010000000100000111011101111011110111000001000100000000001E000000001
100000000100001000000011111111011111000100000001000100000100001000100000000100001000100000001000001000010000100010000011101111111000100000010000000001
100010000100001000000010000100000001111111101111111110111111111000100000000100001000100000001000000000010000100010000010001000001000100000011111101111
100010000110111000000010000100000001000000000000000100000010001111111110111100001000100000001000000000010000100010000000001000001000100000010000100001
111111000000001111110110000000000001000000000000000100000010001000001000000111111111111111111111110111111111111110000010001000001111111110110000100001
100010000100000000000010000100000001000000010000000100000010000000001000000100010000010000010000010000001000100010000010000000001000010000010000100001
100000000100001000000010000100000001000000000000000110111111011000001000000100000000000000000000010000000000100010000010001000001000000000011011111011
100010000100001000000010000100000001110111110000000100000010001000000000000100010000010000010000000000001000100011111111111101111000010000010000100001
111111111111111111111111111111110111000000010000000100000000001000001000000111111011111111111111110000000000000010000001000000001000010000010000000001
100001000001000100000100001000010001000000011111101100000010001111011000000100010000100001000100010000000000100010000000000000001000010000010000000001
100001000001000100000100000000000001000000010000000111111111011000001111101100000000000001000100011111110111111110000001000000001000010000011111011111
100001000000000100000100001000000001110111110000000100001000001000001000000100010000100000000000010001000001000011110111000000001111011111110001000001
110111000001000110111111111111101111000000010000000100000000001000001000000000010000100001000100010001000001000010000001111101111000001000010001000001
100001000001000100000100001000100001000000011110111100001000001000001000000111111111111111011111110001000001000010000001000100000000000000010000000001
100001110111111100000100001000000001000000010000000111101111111111111111011100001000100000001000010000000000000010000001000000001000001000011011101111
100001000100000100000100000000100001000000010000000100001000001000000100000100001000000000000000010001000001000010000001000100001111111011110001000001
111011000100000000000000111111110111000000010000000100000000001000000000000100001000100000001000011111101111111111111011111111111000000000010001000001
100001000100000100000100001000010001111011111111111100000000001000000100000111000001111110111101110000100001000010000000100000001000000000010001000001
100000000000101100000100001000010001000000010000000100000000001111111111011100001000100000001000010000100000000010000000100000001000000000011111111011
100001000100000100000100001000010001000000000000000111110111111000010001000100001000100000001000010000100001000010000000100000001000000100010000010001
100001000100000100000100001000000001000000010000000100010000001000010001000100001000100000001000011000000011000010000000111101111000000100010000010001
100001000100000100000100001000010001111111111111101100000000001000000001000100001111111111111110110000100001110110000000100000001000000100010000010001
111111111110111111111111111111111111000100000010000100010000001000010000000100001000100001000100010000100001000011110111100000001111110110000010000001
100000100000001000010000100001000001000100000010000100010000001000010001000100001000000001000100010000100001000000000000100000001000000100010000011011
100000000000001000010000100000000001000100000000000111111101111110111111111111011000100001000000010000100001000010000000000110111000000100010000010001
100000100000001000000000100000000001000100000010000100001000001000000100000100001111101000000110111110111111111110000000100000001000000000010000010001
100000111011111000010000100000000001101100000011101100001000001000000100000100001000000001101100010000001000000011110111100000001000000110110000010001
111011100000001110111101111110111111000111011110000100001000001000000100000100001000000001000100010000000000000010000000100000001111101100011111111011
100000100000001000010000100000010001000000000010000100000000001000000100000100001000010001000100010000001000000010000000100000001000000100010000100001
100000100000001000010000100000010001000100000010000100001000001000000000000100001000010001000100010000001000000010000000100000001000000100010000000001
100000100000001000010000100000000001000100000010000100001000001000000100000100001000010001000100010000001000000010000000100000001000000100010000100001
100000100000001111011111100000010001111111111111111111111111111111111111111111111111111111111111111111111111111111111111111111111111111110110000100001
110111111111000000010000000000010001000001000000100001000001000000010000010000001000000010000000100010000010000100000100000100001000100000010000100001
100010001000001000010000100000010001000001000000100001000001000000010000010000001000000010000000100010000010000100000100000100000000100000010000100001
100010001000001000010000111101111111000001000000100001000001000000010000010000001000000000000000000000000010000000000100000100001000100000011111110111
100010001000001000010000100000010001000001000000111011111011111110111101110000001000000010000000100010000010000100000111011100001000100000010000100001
100000000000001000000000100000000001000001101111100000000001000000010000000000000000000011111101111111111111110111111100000100001000100000010000000001
100010001000001000010000100000010001101111000000100001000001000000010000010000001000000010000100001000000010000100000100000110111111110111110000000001
111110111111111111111111111110111111000000000000100001000001000000010000011111111011111110000100001000000010000100000100000100001000100000011111011111
100000001000001000010000001000010001000001000000111101111111000000010000010001000000100010000100001000000010000100000111101100001000100000010000000001
100000000000001000010000001000010001000001000000100000100001101111110000010001000000000010000100001000000010000000000100000100001000100000010000000001
100000001000001000000000000000010001000001000000100000000001000000010000010000000000100011101100001000000010000100000000000100000000100000010000100001
100000001000001000010000001000000001110111111111100000100001000000011110110001000000100010000111011000000000000100000100000000000000100000010000100001
111111011111111000010000001000010001000010001000100000100001000000010000011011111111111110000100001101111111111111101111111111110111111110110000100001
100000001000001000010000001000010001000000001000100000100000000000010000010000010001000010000100001000000010000001000100000100010000000000011110111111
100000000000001111111111111111111011000010000000100000100001000000010000010000010001000010000000001000000010000000000100000100010000100000010000100001
100000001000001000010000010001000001000010001000111111111011111111110000010000010001000010000100000000000010000001000000000100010000100000010000000001
100000001101111000000000000000000001000010001000100000010000001000011011111010000011101111011100001000000010000001000100000100000000111110110000100001
111111011000001000010000010001000001000010001000100000000000001000010000010000010000000010000111111111011110000001000100000100010000100000010000100001
100000001000001111111111111101111111111011111111100000010000001000010000010000010001000010000100000010000010000001000100000111110111100000010000100001
100000001000001000010001000000100001000000010000000000011111011110110000010000010001000010000100000000000011101111111111111100010000100000011101111111
100000001000001000000000000000000001000000010000110111110000001000010000011110111101111110000100000010000010000001000001000100010000111011110000100001
100000001000001000010001000000100001000100000000100000010000001000011101110000010000100010000100000010000010000000000000000100000000100000010000000001
111101111111111111111111111111111111101100010000100000010000000000010000010000010000000011111110111111111110000001000001000110111011100000010000100001
100000000000100000001000100001000001000100010000100000010000001000010000010000010000100010000100000010000010000001000001000100010000100000010000100001
100000000000100000000000100001000001000100010000111111011111111111110000011111110111111110000100000010000011101111111111111100010000111011110000100001
100010000000100000001000000001000001000111111101100001000100000100010000010001000010000010000100000000000010000000100010000100010000100000010000100001
110111101100000011111101111000001011101100010000100001000100000100011110110000000010000011101111110111101110000000100010000111011111100000011111111011
100000000000100000001000100001000001000100010000100000000000000100010000010001000010000010000000000010000010000000100000000100010000100000010000100001
100010000000100000001000100001000001000000000000100001000100000000000000010001000000000010000100000010000010000000000010000100000000100000010000000001
100010000000100000001000100001000001000100010000100001000100000100010000010001000010000010000100000010000010000000100010000100010000100000010000100001
111111111111111111111111111111111111111111111111111111111111111111111111111111111111111111111111111111111111111111111111111111111111111111111111111111
