NO ./t3.xpm
SO ./t4.xpm
WE ./t2.xpm
EA ./t1.xpm

F 39, 120, 84
C 207, 24, 230

1111111111111111111111111
1000100000100010000010001
1000100000000010000000001
1000100000100000000010001
1101111011111110000010001
1000100010000011111111011
1000100000000010000010001
1000100010000010000010001
1000000010000010000000001
1000100010000010000010001
1111111111111111111110111
1000000100000100001000001
1000000100000100000000001
1000000000000100001000001
1000000100000100001000001
1000000100000111111011111
1111011110111100000000001
1000000100000100000000201
1000000100000000000100001
1000000100000100000100001
1111011111111111011111011
1000000010000100000100001
1000000000000100000100S01
1000000010000100000100001
1111111111111111111111111
