NO ../assetscolorstone.xpm
SO ../assetswood.xpm
WE ../assetswall_1k.xpm
EA ../assetsbarrel2.xpm

F 98, 188, 238
C 62, 134, 191

111111111111111111111111111111111111111111
100000100000010000001000100001000001000001
100000100000010000001000000001000001000001
100000100000010000001000100001000001000001
111101111110110000001111101111000001000001
100000100000011101111000000000000001000001
1000001000000S0000001000000001101111111011
100000100000010000001000010001000000000001
100000000000010000001111111011000001000001
100000000000010000000000010001000001000001
111111011111111111111000010001110111000001
100001000010000010001000010001000001111011
100001000010000010001000000001000001000001
100001000010000010001000010001000001000001
100001000000000011011111111111110111000001
100000000010000000001000001000100001111011
110111101111110110001000000000100001000001
100001000010000010001000001000100001000001
100001000010000010001000001000000001000001
100001000010000010001000001000100001000001
111111110111111111111111111111111111111111
100000000000000010000010000001000100000001
100000000000000010000010000001000100000001
100000000000000010000010000001000100000001
100000001000000011110111011111101100000001
100000000000000010000010000001000100000001
100000000000000010000000000000000100000001
111111110111111110000010000001000110111111
100000010000100011011111111111111100000001
100000010000100010001000010000000100000001
100000010000100010000000010000000000000001
110111110000000000001000000000000100000001
100000011101100011111101110000000100000001
100000010000100010001000011111101111111011
100000000000100010001000010000000100000001
100000010000100010000000010000000100000001
111111111111110110001000010000000100000001
100000010001000011111101111111101111111011
100000000000000010001000010000000100000001
100000010001000010000000010000000100000001
100000010001000010001000010000000100000001
111111111111111111111111111111111111111111
