NO .t1.xpm
SO .t3.xpm
WE .t2.xpm
EA .t4.xpm

F 149, 4, 222
C 61, 246, 111

111111111111111111111111111111111111111111
100010000010000010001000010001000001000001
100010000010000010000000010001000000000001
100010000010000010001000010001000001000001
100000000010000010001000011000001111101111
110111110111110111111101110001000001000001
100010000010000000001000010001000001S00001
100010000010000010000000010001000001000001
100010000010000010001000011011111111111111
111111101111111111111011110000100010000001
100001000010000100010000010000000010000001
100000000010000100010000010000100010000001
100001000010000100010000000000100000001111
100001000011100000111110110000100010000001
111111101110000100010000010000100010000001
100001000010000100010000011110111110000001
100001000010000100000000010000100010000001
100001000000010111111101110000100011011111
100001000010000100010000010000000010000001
100000000010000000010000010000100010000001
100001000010000100010000010000100010000001
111111111111111111111111110111111111111111
100001000100000100001000100000100010000001
100000000100000100000000100000000010000001
100001000100000100000000100000100010000001
111011111100000100000000111101110000011011
100001000111101111110111100000100010000001
100000000100000100000000100000100010000001
100001000100000100000000100000100010000001
100001000100000100000000111011110111111111
100001000100000000011101100000100000010001
100001000100000100001000100000100000010001
111111101100000100001000000000100000010001
100010000111101100001000100000110110000011
100000000100000110111111111111100000010001
100010000100000100000001000000100000010001
100010000100000100000000000000100000010001
111111101111101100000001000000111111111011
100001000000000100000001000000100010000001
100000000100000100000001000000100000000001
100001000100000100000001000000100010000001
111111111111111111111111111111111111111111
