NO .t3.xpm
SO .t2.xpm
WE .t1.xpm
EA .t4.xpm

F 242, 190, 192
C 151, 100, 189

11111111111111111111111111111111111111111111111111111111111111111111111111111111
10000001000010000010000010000010000010000010001000000010000100001000010001000001
10000001000000000010000010000000000010000010001000000010000000000000010000000001
10000001000010000010000010000010000010000010001000000010000100001000010001000001
11111011110111100000000011111111011110000010001000000010000100001000011111011111
10000001000010000010000010001000000000000011011000000011111111011111110001000001
10000000000000000011110000001000000010000010001000000010001000000100010000000001
10000001000000000010000010000000000011101110001111110110001000000100010000000001
10000001111101111110000010001000000010000010001000000010001000000100011110111111
11101111000001000010000011011000000010000010000000000010000000000000010000000001
10000001000001000010000010001000000010000010001000000010001000000100010000000001
10000001000000000000000010001111110111011111011111111110001000000100010001000001
10000001000001000000000010001000000010000010000000100011111011111111110001000001
11111111111111111101111110000000000010000010000000100010000010001000011011101111
10000010001000010000100010000000000010000010000000100010000010000000010000000001
10000010001000010000000011110111111110000010000000100010000010001000010001000001
10000010001000010000100010000000100010000011110100000010000011111101110001000001
10000000001000011111101110000000100010000000000000110000000010000100000011101111
10000010000000010000100010000000000011011110000000100011110110000000010000100001
10000010001000010000100011011111100010000010000000100010000010000100010000100001
11101111111110000000000010000000110110000010000000100010000000000100010000000001
10000010001000010000100010000000100010000010000000100010000010000100010000100001
10000000001000010000000010000000100011101111011111111111111111111111110000100001
10000010001000010000000010000000100010000010000000100001000000100000010000100001
11101111011111111111011111101111111110000010000000100001000000100000011111110111
10000010001000001000000010000001000010000010000000100000000000000000010001000001
10000000001000000000000010000000000010000010000000000001000000100000010000000001
10000000001000001000000010000001000010000010000000100001000000100000010001000001
11111101111111111111111111111111111111111111111111111111111111111111111111111111
10000000100000001000000100000100001000100010000000100010000001000000010001000001
10000000100000001000000100000100001000100010000000100010000001000000010000000001
10000000000000001000000100000100001000100010000000100010000001000000010001000001
10000000111110111111100000111100001101100010000000100011101111101111110001000001
11011111100000001000000100000000011000100010000000100010000001000000010001000001
10000000100000001000000100000100000000100011111100000110000001000000011111111011
1S000000100000001000000100000100001000110110000000100010000001000000010001000001
10000000100000001000000100000100001101100010000000100000000001000000010001000001
11111111111101111000000100000100001000100000000000100010000000000000010000000001
10000010000000001111110111111111111000100010000000100010000001000000011011111011
10000010000000001000000100010000001000111111111011111111111111111111110001000001
10000010000010000000000100010000001101100000100010000001000100000100010001000001
11110111101111111000000100000000001000100000000000000000000000000000010000000001
10000010001000001111000000110000001000100000100010000001000100000100010000000001
10000000001000001000000100010000001000111111111111111011111111111111111110111111
10000010001000001000000100011110111101100001000000100000001000001000010000100001
10000010001000001000000100010000001000100001000000100000001000001000010000100001
10000010000000001000000100010000001000100001000000100000001000000000010000100001
10000010001000001000000100010000001000100000000000111111000000111110110000000001
11111011111111111110111111111111111111110111110111100000001000001000010000100001
10000000100000001000000010000010000000100001000000100000001000001000011110111111
10000000000000001000000010000000000000000001000000100000001000001000010000010001
10000000100000001000000010000010000000100001000000111111111111011111110000000001
10000000100000001000000000000011101111111011111111100001000001000000010000010001
11111101111111111000000010000010000000100000100000000000000001000000011111111011
10000001000100001111101111011110000000100000100000100001000001000000010000010001
10000001000100001000000010000010000000100000100000100001000001000000000000010001
10000001000100001000000010000011111011111101100000100001000001000000010000000001
11011000000110111000000010000010000000100000110111111011111111111011110000010001
10000001101100001000000010000010000000100000100000100000100000000000011111110111
10000001000000001000000010000010000000100000000000100000100001000000010001000001
10000001000100001111111110111111111111100000100000100000000001000000010001000001
10000001000100001000001000010000100000100000100000100000100001000000010000000001
11111111111111011000001000010000000000110111111111111111111111111111110001000001
10000100001000001000001000000000100000100000100000001000010000000100010001000001
10000100001000001000001000010000100000100000100000001000010000000100010001000001
10000100001000001110111000010000100000100000100000001000010000000000011111110111
11101110000000111000001111110111111111100000100000001101111110111110110001000001
10000100001000001000001000000000001000111011111110111000010000000100010001000001
10000000001000001000001000000000001000100000100000000000010000000100010000000001
10000100001000001000001000001000001000100000100000001000010000000100010001000001
11110111111111111101000000000000001000100000000000001000000011111111111111101111
10000000001000001000001111011111011000110111111101111110110000001000010000000001
10000000001000001000001000001000000000100000100000001000010000000000010000000001
10001000001000001000001000001000001101100000000000001000010000001000010000010001
10001000000000111000001000001000001000100000000000001000010000001000011101110001
11000001011000001111011111111110111000111111011111111111111111111111110000011011
10001000001000001000001000000010001000100000010000100000100010000100010000010001
10001000001000001000001000000000001000100000000000000000000000000000010000010001
10001000001000001000001000000010001000100000010000100000100010000100010000010001
11111111111111111111111111111111111111111111111111111111111111111111111111111111
