NO .t3.xpm
SO .t2.xpm
WE .t4.xpm
EA .t1.xpm

F 179, 143, 197
C 227, 106, 231

11111111111111111111111111111111111111111111111111111111111111111111111111111111
10000010001000010000010001000010000001000010000001000100001000000010000100000001
10000010000000010000010001000010000000000010000000000100001000000010000100000001
10000000001000010000010001000010000001000010000001000100001000000010000100000001
10000010001000011101111011000011011111110000010111101100000000000000000000000001
11111111011111110000010001110110000100000010000001000100001000000010000100000001
10001000000000010000000000000010000100000010000001000111111011111110000100000001
10001000000000010000010001000010000000000010000001000100001000000011111111011111
10001000100000010000010001000011011111110111111011111100001000000010000100000001
10001000100000011111110111111110000100000010000001000100001000000010000000000001
10001000000000010000000000000010000100000010000000000111011000000010000100000001
10000000100000010000000000000010000100000010000001000100001101111110000100000001
11011101111111110000000000000010000100000010000001000100001000000010000100000001
10001000000100010000001000000011111110111111011111111100000000000011101111111011
10001000000000010000001000000010000010000010000100000000001000000010000100000001
10001000000100010000001000000010000000000010000000000100001000000010000100000001
11111111101111111111111110111110000010000010000100000100001000000010000100000001
10000010001000010000001000000011111111111111111110111111111111111111111111101111
10000010000000010000001000000010000000100010001000010001000001000010000100000001
10000010001000010000001000000010000000100000000000000001000001000010000100000001
10000010001000011011111000000010000000100010001000010001000000000010000100000001
10000000001000010000001000000010000000100011011111111000000001000011100000111111
10000010001000010000001000000000000000110110000100010001111111011110000100000001
11111011111111110000001111101110000000100010000100010001000100000010000100000001
10001000100000011011111000000011111101100010000000010001000000000010000100000001
10001000100000010000001000000010000000100010000100010001000100000010000100000001
10001000000000010000000000000010000000110111111111111111000100000010000100000001
10001000100000010000001000000010000000100010000100000001000100000011111111111011
10001111111101111111111110111110000000100000000100000001000100000010000001000001
11011000001000010001000000000010000000100010000000000001101111111110000001000001
10001000001000010000000000000010000000000111011100000001000001000010000000000001
10001000001000000001000000000011101111100010000100000001000001000010000001000001
10000000000000111011101111110110000000100010000111101111000000000011110111111111
10001000001000010001000001000010000000100010000100000001000001000010000000100001
10001000000000010001000001000010000000100000000100000001000001000010000000000001
10001000000000010001000001000010000000100010000100000001000001000010000000100001
11111111110111111111111111111111111111111111111111111111111111111111111111111111
10000000100010001000000100010000001000010000100000001000010000010000010000100001
10000000100010001000000100000000001000010000100000001000010000010000000000100001
10000000100010001000000100010000001000010000100000001000000000010000010000100001
11101111100011011000000100010000000000011101111110111110111101111101110000000001
10000000000110000000000100010000001000010000100000000000010000010000011101111011
10000000100010001110111110111111111110110000100000001000010000010000010000100001
10000000100000001000000000010000001000010000100000001000010000010000010000100001
10000000100010001000000100010000000000010000111111111101111111110000010000100001
11111111111110111000000100010000001000010000100000001000000100011111111111110111
10000001000100001110111111110000001000011000000000001000000100010000000100000001
10000001000000001000010000010000001100000000100000001000000100010000000100000001
10000001000100001000000000011011111000010000100000001111101110110000000100000001
11110000000100001000010000010000001000010000100000001000000100010000000100000001
10000001111110111000010000010000001000010000111011111000000000011111000000111111
10000001000100001000010000010000001000011101100000001000000100010000000100000001
10000001000100001111111111011111111111110000100000001111011111110000000000000001
10000001000000001000010001000001000000010000100000001000000000010000000000000001
10000000000100001000000001000000000000010000100000001000000000011111111011111111
10000000000100001000010001000001000000010000100000000000100000010000100010000001
11111110111111111111110111110111111101111101100000001000100000010000100010000001
10000000100000001000100001000001000000010000111111011111111111110000100010000001
10000000000000001000000001000001000000010000100000000000100000010000110000001111
10000000100000001000100000000001000000010000100000000000100000010000100010000001
11011111100000001000100001000001000000010000100000100000100000011101100010000001
10000000111111011111111111111111110111111111111101100000000000010000000010000001
10000000100000001000100000100000100000100000100000100000100000010000111111011111
10000000100000001000000000000000100000100000100000000011111111110000100010000001
10000000100000001000100000100000100000100000100000100010001000010000100000000001
1111110111111111111111111111110111011111S111111011100000001000010000100010000001
10001000010000001000001000001000100000100000100000100010001000011111101111111111
10001000010000001000001000001000100000000000100000100010001000010000100000010001
10000000010000001000001000001000100000100000100000100010000000000000100000010001
10001000010000001000001111000001111111111101100000100010001000010000100000000001
11011101111101111111011000001000100000001000110111111111111111110000000000010001
10001000000000001000000000001000100000001000100010000100010000010000100000010001
10001000010000001000001000001000100000001000100010000000010000011111111111011111
10001000010000001000001000001000110111111000100000000100010000010000010001000001
10001000010000001000001111111100000000001101100010000100010000010000010001000001
11111110111111111101111000100000100000001000110111111110111011110000000001000001
10001000001000001000001000100000100000001000100010000100010000010000010001000001
10000000000000001000001000000000100000000000100010000000000000010000010000000001
10001000001000001000001000100000100000001000100010000100010000010000010001000001
11111111111111111111111111111111111111111111111111111111111111111111111111111111
