NO ./t3.xpm
SO ./t1.xpm
WE ./t4.xpm
EA ./t2.xpm

F 21, 77, 72
C 33, 101, 59

################################################################################
#     #    #     #      #       #   #      #       #   #   #       #    #      #
#     §    #     #              #   #      #           #   #       #    #      #
#     #    #     #      #       #   #              #   #   #       #    #      #
#########        ###########§####   #      ## ######   ##          ##§###      #
#     #    #     #      #       ## ##      #       ##§##   ######       #      #
#     #    #     #      #       #   #      #       #   #   #       #    #### ###
#          #### ##      #       #   #### ###       #   #   #       #           #
##§###### ##     §      ## ######   #      ###§#####   #   #       #    #      #
#     #    #     #####  §       ##§##      #       ##  §  #######§#######      #
#     #    #     #      #       #   #      #       #   #    #   #       #      #
#     #    #     #      #                  #       #   #    §   §       ### ####
#####§############      #       #   #              #   #    #   #       #      #
#   #     #      #      #       #   #              #   ## ############§##      #
#   #     #      ####§##################### ############    #   #       #      #
#   #     #      #     #    #   #   #     #    #       #    #   #       #      #
##§#### ######§###     #    #   #   §          #       #    #   #       #####§##
#   #     #      #          §   #   #     #            ##§#### #######§##      #
#         #      ####§###§#### ##   #     #    #       #    §   #       #      #
#   #     #      #     #    #   ##§###§#################    #   #       #      #
##### #####      #     #    #   #   #    #   #   #     #    #   #       #      #
#     #          #     #    #   #   #    §   #   #     ############## ####### ##
#     #   #      ######## #### ##   #    #   #   §     #     #   #      #      #
#     #   ### ####   #      #   ## ###§#######   #     #     #   #      #      #
#     #   #      #   #      #   #   #    #   #   #     #     #   #      #      #
#         #      #          #   #   #    #   #   #     #     #   §      #      #
#     #   #      #   #      #   #   #        ### ########## ##   #      #      #
#########################§#######   #    #   #     #   #     ###§############ ##
#     #    #     #      #       ##§######## ##     #   #     #     #    #      #
#     #          #      #       #   #    #   #         #     #     #    #      #
#     §    #     #              #   #    #   ## ##### #### ###     #    #      #
#     #    #     §      #       #   #        #     #   #     #     §    #      #
#     #    #     #      #       #   #    #         #   #     §     #    #      #
#     #    #     #      #       #   #    #   #     #   #     #     #    #      #
################################################################################
