NO ./t1.xpm
SO ./t3.xpm
WE ./t2.xpm
EA ./t4.xpm

F 23, 155, 84
C 248, 156, 179

1111111111111111111111111
1000000010001000000100001
1000000010000000000100001
1000000000001000000000001
1000000010001000000100001
1111111111011111111111111
1000000100000010000010001
1000000100000010000010001
1000000100000010000010001
1000000100000010000000001
1000000000000010000010001
1000000100000011111110111
1110111111111110001000001
100000100000001W000000001
1000001000000010001000001
1000001000000010001000001
1000000001110111011111011
1000001000000010001000001
1000001000000010001000001
1101111000000010001000001
1000001111011111111101111
1000001000000010001000001
1000001000000000000000001
1000001000000010001000001
1111111111111111111111111
