NO ./path_to_the_north_texture
SO ./path_to_the_south_texture
WE ./path_to_the_west_texture
EA ./path_to_the_east_texture
F 220,100,0
C 225,30,0

      1
   11111111111111111111111111
  110000001 100000000000001
   10111101 111101010111111
 111010100111  10000011
 1000000011    11101101
 1011111101    101001111
 10111  101111111011101
 10101  101 1 1 111 1111
 10101  101111111111111
 10001  101           11
 111111 101 1  11  1  1
 1 1 1  1011111111111111
 1 1    100000000000001
 1      1111111111111111
               1
