NO ./resources/bluestone.xpm
SO ./resources/greystone.xpm

WE ./resources/colorstone.xpm

EA ./resources/eagle.xpm

F 220,100,0
C 225,30,0

 1 1 1       1 1 1   1111 111111111111
       1 1 1  1 1 1  1001 100000000001
 1 1 1 1             1011 101111111101
       1111 1  1     101  101      111 11111111111
       11            101  101          10000000001
 111   1111 1   1    10111101111111111 10111111101
 101 11111111 11111  10000000000000001 101     101
1111          10001  11111111011111011 101 111 101
        11111 11111         101   101  101 101 101
  11111 1001  11     111    101   101  101 111 101
  1W01  1111         1011111101  1101  101     101
  1111 11  11        1000000001  1001  10111111101
                     1111111111  1111  11111111111
